push-up	armheving
voice over	fortellerstemme, kommentatorstemme
workspace	arbeidsområde, arbeidsflate (IKT)
deadline	leveringsfrist, tidsfrist, frist
designer	formgjevar/formgiver
m-commerce	m-handel, mobilhandel
hotlist	favorittliste, yndlingsbokmerke/yndlingsbokmerker (IKT)
off-piste	laussnøkjøring/løssnøkjøring, frikjøring
quilte	sy (vattert) lappeteppe, jf. patchwork
tights	trongbukse/trangbukse
blackout	jernteppe, minnesvinn (allment); mellombels medvitstap / midlertidig bevissthetstap (med.); stort straumbrot / stort strømbrudd (tekn.)
finish	sluttspurt; finpuss; finisj
hit-and-run	ram og røm
stretchlaken	strekklaken
sweatshop	lavlønnsfabrikk, systove / systue (historisk)
thumbnail	miniatyrbilete/miniatyrbilde, knøttbilete/knøttbilde (IKT)
voice response	talesvar, innvalssørvis/innvalgssørvis, talerespons
approach	tilnærming(småte), framgangsmåte, (innfalls)vinkel
mansplaining	gubbedosering, gubbebelæring / gubbelæring, mannstruering, stutgreiing
netbook	miniberbar/minibærbar (datamaskin, pc) (IKT)
controller	rekneskapsleiar/regnskapsleder, økonomioppfølgjar/økonomioppfølger, kontrollar/kontroller
killer application («killer app»)	tetprogram, vinnarprogram/vinnerprogram (IKT)
zero waste	null avfall, nullavfall, null svinn, nullsvinn
faction	faksjon (fakta + fiksjon)
speaking notes	handnotat/håndnotat, foredragsmanus, talemanus, talenotat/talenotater
bodybuilding	kroppsbygging
brainstorming	idédugnad, idémyldring
cyber	kyber- (brukt om datamaskiner og Internett-universet)
gadget	dings
segway	ståhjuling (er allerede godt etablert i norsk)
single touch-screen	enkelttrykksskjerm/eittrykksskjerm (IKT)
design	formgjeving/formgivning, utforming, jf. layout
fair	rimeleg/rimelig, rettferdig, real, ærleg/ærlig
stalker	forfølger/forfølgjar, (nyno. òg:) eltar
underscore	understrek, understreking
cash management	likviditetsstyring
cottage cheese	hytteost
cyberstalking	nettforfølging/nettforfølgelse, nett-elting, nettsjikane, netterror
housed	husa/huset
stand-in	reserve
branding	merkevarebygging (nær.liv); brennemerking (tatoveringsteknikk)
employer branding	arbeidsgjevarprofilering/arbeidsgiverprofilering
recovery	(helse) tilfrisking/tilfriskning
rockhopping	(i havpadling:) brot(t)leik, brot(t)padling
build	versjonssteg, versjonstrinn (IKT)
front-office	kontorklient(program), jf. backoffice
loin	(om fisk:) rygg (f.eks. torskerygg), ryggstykke, ryggfilet (uten halestykket)
shoppingsenter	kjøpesenter, butikksenter
speed dating	snøggstemnemøte/hurtigstevnemøte 
turnover	gjennomtrekk, utskifting, gjennomstrøyming/gjennomstrømming 
bake-off	ferdigheva/ferdighevet, halvsteikt/halvstekt (bakverk som er klargjord for heving og steiking); ferdigsteikt/ferdigstekt; bakekonkurranse (tv-program)
entertainer	underhaldar/underholder, underhaldningsartist/underholdningsartist, enterteinar/enterteiner
scoop	varp, nyheitskupp/nyhetskupp, skup
paring	(mobil) parkopling, paring
snowboard	snøbrett
supporterklubb	støtteklubb, tilhengjarklubb/tilhengerklubb, jf. fanklubb
understatement	underdriving/underdrivelse
crabsticks	krabbepinnar/krabbepinner
flop	fiasko, flopp
headhunte	handplukke/håndplukke, drive hovudjakt / drive hodejakt
babymoon	svangertur, svangersvipp, førbarselreise
cover charge	inngangspengar/inngangspenger, kuvertavgift, entré
paramedic	paramedisinar/paramedisiner (person)
handout	støtteark
key account manager	hovudkundeansvarleg/hovedkundeansvarlig, nøkkelkundeleiar/nøkkelkundeleder, nøkkelkundekonsulent
team	(arbeids)lag, (samarbeids)gruppe
voice actor	stemmelegger
baby shower	
babygåvedryss/babygavedryss, ventefest, førbarselsfest
byline picture	signaturbilete/signaturbilde
feature	preg-, bakgrunns-, dokumentar-, interesse-, tema- (i ymse samansetjingar, t.d. med -artikkel , -journalistikk)
tooltip	verktøyhjelp (IKT)
mainstream	hovudstraums-/hovedstrøms-, midtstims-, midtstraums-/midtstrøms-
memory card	minnekort
referee	fagkonsulent (i tidsskrift)
equalizer	tonekontroll; utjamnar/utjevner, utjamningsfilter/utjevningsfilter, jf. graphic equalizer
time	berekne/beregne, planleggje/planlegge, taime
blooming	punktforteikning/punktfortegning, svelling (tekn., IKT)
button	(jakke)merke (allment); knapp (IKT)
driver	drivar/driver (norsk uttale), styreprogram
instant message	direktemelding, hurtigmelding, snøggmelding
skateboard	rullebrett
golden goal	førstemålssiger/førstemålsseier, «første målet vinn» / «første målet vinner»
metallic	(med) metallglans
whistleblower	varslar/varsler
offroad-sykkel	terrengsykkel, jf. mountain bike
poster	plakat
server	tenar/tjener, jf. webserver
trick or treat	knask eller knep, godteri eller fanteri, snask eller snusk, grøss eller godteri (seier barna på graskarkvelden: amerikansk Halloween)
allrounder	allsidig person, altmoglegperson/altmuligperson, mangkunnig person, faktotum, «potet»
benchmarking	referansemåling, referansenormering, styringsnormering
e-business	e-forretningar/e-forretninger, e-forretningsdrift; e-forretning (om det enkelte firmaet)
session-at-once	delbrenning, øktbrenning, fleirøktsbrenning/flerøktsbrenning, jf. disc-at-once
chip	(data)brikke, integrert krins / integrert krets, jf. integrated circuit, microchip
multi touch-screen	fleirtrykksskjerm/flertrykksskjerm (IKT)
proof of concept (poc)	konseptprov/konseptbevis
musical	musikkspel/musikkspill, musikal
breakdance	breikdans
greenkeeper	golfgartnar/golfgartner
lipgloss	leppeglans
orphan drug	smalt lækjemiddel / smalt legemiddel, fåbrukarmedikament/fåbrukermedikament
outlet	fabrikkutsalg, merkevareutsalg
time manager	tidsplanleggjar/tidsplanlegger
time-outtime outtimeout	det å gå i tenkjeboksen / det å gå i tenkeboksen, pause (ped.), tidsavbrot / tidsavbrudd (IKT)
eyeliner	kajal, augeblyant/øyeblyant, jf. lipliner
fair play	ærleg spel /ærlig spill, rettferdig behandling
fund raising	pengeinnsamling, innsamlingsaksjon
to-do-liste	gjereliste/gjøreliste, gjeremålsliste/gjøremålsliste
touch screen	trykkskjerm
wearable computer	kropps-PC, kroppsboren datamaskin / kroppsbåret datamaskin, plagg-PC
access	tilgang
mnemonics	hugsekunst/huskekunst, hugseteknikk/husketeknikk
spotlight	punktlys, punktlampe, spotlys, rampelys
slash	skråstrek
soundtrack	lydspor
backlog	restanse, etterslep
match	kamp (idr.); jambyrdig motstandar / jevnbyrdig motstander, make; (full) klaff
ransomware	løysepengevirus/løsepengevirus, utpressingsvirus, gisselskadevare
video on demand	video på førespurnad / video på forespørsel; videotorg, tingingsvideo/bestillingsvideo
disc-jockey	plateprater, platesnurrer, platekusk, plateryttar/platerytter, diskjockey
podcast	podkast, poddkast
rail	takreling, takhaldar/takholder (tekn.); reling (allment)
release	plateslepp/plateslipp
talkshow	prateprogram
fatbike	tjukksykkel, tjukkel
lighter	(sigarett-)tennar/(sigarett-)tenner
must	nødvendigheit/nødvendighet
empowerment	myndiggjering/myndiggjøring, styrking (f.eks. pasientstyrking)
literacy	skriftkultur, skriftkunne/skriftkyndighet, tekstkompetanse, litterasitet
standbymodus	ventemodus, kvilemodus/hvilemodus (tekn., IKT)
breakdown	samanbrot/sammenbrudd, havari, driftsfeil, oppdeling, spesifikasjon
help desk	hjelpesentral, hjelpeteneste/hjelpetjeneste, kundehjelp, svarteneste/svartjeneste, jf. call center og support
standby	klar, parat, i beredskap (allment); beredskaps- (-fartøy, -troppar o.a.) (mil.)
web designer	vevutformar/vevutformer, nettskreddar/nettskredder, vevarkitekt, nettsidearkitekt
back-office	kontortenar(program)/kontortjener(program) (IKT); kontorstøtte (adm.); jf. front-office
by-line (byline)	namnestripe/navnestripe, signatur
rack	reol (mus., IKT, allment)
publishing on demand	medieuavhengig publisering, medienøytral publisering, jf. print on demand og on demand
content management	innhaldsstyring/innholdsstyring
empower	myndiggjere/myndiggjøre, styrke, gje/gi styrke, setje i stand / sette i stand
feed	straum/strøm (i sosiale medium/sosiale medier)
urbanist	byplanleggjar/byplanlegger
whiteboard	tusjtavle
backing	støtte, hjelp, oppfølging (allment); komp, akkompagnement, støtte (mus.); jf. oppbacking, backup
double slash	dobbel skråstrek / dobbelt skråstrek, jf. slash
maile	sende e-post, e-poste
junk food	søppelmat, usunn mat, gatekjøkkenmat, jf. fast food
paper	forskingsartikkel/forskningsartikkel, vitskapleg innlegg/vitenskapelig innlegg
roaming	nettveksling, nett(om)streifing, nettgjesting
screen dump	skjermdump, skjermbiletkopi/skjermbildekopi
supporter	tilhengjar/tilhenger, støttemedlem
browser	nettlesar/nettleser
crowdsourcing	(nett)dugnad
file server	filtenar/filtjener
system engineering	systemutvikling
common sense	sunn fornuft, folkevett/folkevit
content marketing	innhaldsmarknadsføring/innholdsmarkedsføring
guide	omvisar/omviser, turleder/turleiar, reiseleiar/reiseleder, gaid
skins	drakt, tema, ham (IKT), jf. themes
target man	oppspelspunkt/oppspillspunkt (idr.)
timeshare	tidspart, deltids(bruks)rett; parts-/andels- (t.d. -båt, -hytte)
e-book reader	lesebrett
process flow	prosessflyt
scroll bar	rullefelt, rullesjakt (IKT)
happy hour	billigtime, timetilbod/timetilbud
printer	skrivar/skriver
case	(jf. case study:) kasus, tilfelle, sak, emne, eksempeltilfelle (-person osv.), døme(tilfelle), typeeksempel, typedøme; undersøkelsesobjekt, granskingsemne
chat	nettprat
guts	(ha) mot, pågangsmot, vågemot, karakter(styrke), tæl, nerk; (være/vere) modig, djerv, uredd, ikke/ikkje skvetten
shoppe	handle, gå på handletur, gå i butikkar / gå i butikker
standbybillett	sjansebillett
think-tank	tenkjesmie/tenkesmie, tenkjetank/tenketank
all hazards approach	heilskapleg faretilnærming / helhetlig faretilnærming, generell faretilnærming, fullstendig faretilnærming
compliance	etterleving, regeletterleving/regeletterlevelse, regeloppfylling/regeloppfyllelse, samsvar
dedicated	engasjert, ihuga, heilhjarta/helhjertet (allment); dedisert (litt.); dedikert, (særskilt) tilordna/tilordnet og tilpassa/tilpasset (IKT), laga/laget for
baby lag	vaketåke/våketåke
handsfree	handfri/håndfri (mobiltelefon)
multitasking	fleiroppgåvekjøring/fleroppgavekjøring (IKT)
flow	strøm; (psyk.:) flyt
workflow	arbeidsflyt, arbeidsgang
out-of-office message	fråværsmelding/fraværsmelding
pop-up menu	oppsprettsmeny, sprettoppmeny, hurtigmeny, snøggmeny
whiplash	nakkesleng
access code	tilgangskode
dot	punktum (i Internett- og e-postadresser)
e-tailer	e-taljist, nettkjøpmann
knowledge management	kunnskapsleiing/kunnskapsledelse, kompetanseleiing/kompetanseledelse
sous vide	vakuumlaga mat / vakuumlaget mat, vakuumtilverka mat / vakuumtilberedt mat, vakuumtrekt mat / vakuumtrukket mat, vakuumtilverking / vakuumtilberedelse
worst case scenario	i verste fall, verste fall-scenario, verste tilfelle-scenario
attachment	vedlegg
babyboomer	babybølgjebarn/babybølgebarn, fødselsbølgjebarn/fødselsbølgebarn
desktop publishing	skrivebordssetjing/skrivebordssetting
wizard	vegvisar/veiviser, los (i dataprogram)
workshop	arbeidsseminar, arbeidsmøte, verkstad/verksted (f.eks. idéverkstad/idéverksted)
backlash	tilbakeslag, motreaksjon
cellulite	appelsinhud, cellulittar/cellulitter
twintip	totupp
infotainment	info(r)nøyelse, nyheitsunderhaldning/nyhetsunderholdning, tabloid-
makerspace	folkeverkstad/folkeverksted
wicked problem	gjenstridig problem
hi-tech	høgteknologisk/høyteknologisk
jingle	lydvignett, lydlogo
plug-in	programtillegg
backtracking	tilbakesporing (IKT)
canyon	gjel, kløft, juv
gender reveal party	kjønnsavsløringsfest
scrapie	skrapesjuke/skrapesyke (hos sau)
software	programvare
sound	klangfarge, lydstil
bookmark	bokmerke, favoritt
insider	innsidar/innsider
performance-kunst	framføringskunst
chips	potetgull, potetlauv/potetløv; (mer allment:) flak, spon
hard disk	platelager, harddisk
short message system (sms)	kortmeldingsteneste/kortmeldingstjeneste (for SMS-meldingar, dss. tekstmeldingar)
quilt	(vattert) lappeteppe, jf. patchwork
bodybuilder	kroppsbyggjar/kroppsbygger
factoring	faktoring, fakturakreditt
keyboard	tangentbrett (mus.); tastatur (IKT)
single hop	einhumla øl / enhumlet øl
embed	bygge inn / byggje inn, setje/sette, felle
leasing	leigefinansiering/leiefinansiering
outsider	utsidar/utsider
outsourcing	utkontraktering, tenesteutsetjing/tjenesteutsetting 
fun fact	morofakta
manual	handbok/håndbok, bruksrettleiing/bruksanvisning
noise words	støyord (IKT)
housing	husing
kick-off	avspark (idr.); oppstart, start (allment)
management	leiing/ledelse (bedrifts-), styring
roll-up	rullebanner, rulleplakat
streaming	strøyming/strømming (direkteavspeling/direkteavspilling av video og lyd over Internett) (IKT)
aftershave	etterbarberingsvatn/etterbarberingsvann
catwalk	motemolo
deep fake	avansert videomanipulering
browse path	katalogstig/katalogsti, filstig/filsti (IKT), jf. search path
mail	e-post, e-brev, e-melding, jf. e-mail
release party	(plate)sleppfest/(plate)slippfest
support	brukarstøtte/brukerstøtte (IKT); støtte (allment); jf. help desk
webmaster	nettredaktør, nettadministrator, nettmeister/nettmester, vevadministrator, vevmeister/vevmester, vevredaktør
ghost writer	skyggeforfatter / skuggeforfattar
mute	dempar/demper
patch	reparasjonsfil, programfiks, feilfiks (IKT)
peer-to-peer network	likenett, jambyrdsnett/jevnbyrdsnett
p2p	likenett, jambyrdsnett/jevnbyrdsnett
peptalk	peppreik, pepprat, kveikpreik, piffprat
sit-up	magebøying, bukbøy
clue	nøkkel, kjerne, poeng
frisbee	disk, skjenebrett, sendeplate
keeper	målvakt
beacon technology	mobilfyrteknologi, nettvardeteknologi
mindfulness	oppmerksomt nærvær / merksamt nærvær, ans
dummy	modell, prototyp, falsk, uekte, skinn-
india pale ale	indiaøl
joint venture	samføretak/samforetak, fellesføretak/fellesforetak, samarbeidsprosjekt
backslash	omvend skråstrek / omvendt skråstrek
lipliner	leppeblyant, leppekajal, jf. eyeliner
whiteboard-svamp	tavleviskar/tavlevisker
infomercial	infoklame
offline	nedkopla/nedkoplet, fråkopla/frakoplet, jf. online
selfie	sjølis, selvis / sjølvis, selvportrett, sjølportrett / sjølvportrett, selvfoto, sjølfoto / sjølvfoto, selvknips, sjølknips / sjølvknips, egofoto, egobilde/egobilete
aircondition	klimaanlegg, luftkondisjonering
copyright	opphavsrett
hardware	maskinvare
muddling through	småstegsmetoden / de små skritts metode [prosess, metode]
teambuilding	lagutvikling, lagbygging
trigge	setje i gang / sette i gang, utløyse/utløse
allround-	altmogleg-/altmulig-, allsidig, allmenn-, universal-
art director (ad)	kunstnarleg leiar/kunstnerisk leder (teater m.m.); grafisk formgjevar/formgiver (rekl.); reklamesjef (arb.liv)
artist in residence	gjestekunstnar/gjestekunstner
manager	leiar/leder, sjef, forretningsførar/forretningsfører, impresario, arrangør
swimming pool	symjebasseng/svømmebasseng
backlist	tittellager, tittelportefølje (allment); bokportefølje (i forlag)
business-to-business	handel mellom næringsdrivande / handel mellom næringsdrivende, handel mellom bedrifter, bedriftshandel
image	uttrykk, (personleg/personlig) stil, profil, omdømme, ry
bodyguard	livvakt
booster	forsterkar/forsterker, effektforsterkar/effektforsterker, sluttforsterkar/sluttforsterker
direct mail	direktereklame
default	standard(verdi), standardinnstilling (grunn-, forhånds-, normal-, leverandør-, produsent-)
live	direktesend/direktesendt, direkte
network governance	nettverksstyring
newsgroup	temagruppe, nyheitsgruppe/nyhetsgruppe, diskusjonsgruppe (IKT)
patchwork	lappeteknikk, jf. quilt
barbecue	(hage)grill; grillmat; grillfest
boote	starte (datamaskin), kaldstarte, jf. restart
citizen science	grasrotforsking
pitchekonkurranse 	innsalskonkurranse/innsalgskonkurranse 
pole position	beste startspor
best practice	mønsterpraksis, bestepraksis, beste praksis
geek	fagidiot; særling; dust
laptop	berbar (datamaskin, pc) / bærbar (datamaskin, pc) (IKT)
canyoning	juving, juvvandring
internet service provider (isp)	internettilbydar/internettilbyder
on-hook dialing	rørlaus oppringing / rørløs oppringing
adde	(IKT) leggje til, leggje inn / legge til, legge inn
debug	avluse; feilsøkje/feilsøke; rette programfeil, fjerne programlus; jf. bug
editor	redigeringsprogram (IKT)
establishment, the	det beståande / det bestående (samfunnet), etablissementet
trainee	opplæringstilsett/opplæringsansatt, opplæringskandidat, aspirant, praktikant
turnspeak	vrengjetale/vrengetale
screening	masseundersøking
telemarketing	telefonsal/telefonsalg, marknadsføring/markedsføring (over telefon)
benchmark test	yteprøve (IKT)
calling	dørtelefon (på hus)
cross media publishing	tverrpublisering, tverrmedial publisering
global positioning system (gps)	globalt posisjonsystem (GPS)
advocacy campaign	påverknadskampanje/påvirkningskampanje
co-branding	merkevaresamarbeid, merkesamarbeid
cookie	informasjonskapsel, infokapsel, kjeks (IKT)
web pad	nettbrett
sub-woofer	sub-bass(høgtalar)/sub-bass(høyttaler)
throbber	puls-ikon (ikon i nettlesarar som er animert under søk el. nedlasting)
web hotel	vevhotell
cole slaw	kålsalat
influencer	påverkar/påvirker
reverse engineering	omvend/omvendt utvikling, tilbakevikling, inversutvikling
franchise	forhandlarrett/forhandlerrett, agentur
roll-on	(kule)deodorant, (uformelt:) rulledeo
fight	(hard eller intens) kamp, hardt oppgjer / hardt oppgjør, fait
flip-over	arktavle, papirtavle, stativblokk, flippover
graphic equalizer	grafisk tonekontroll, jf. equalizer
raw food	råmat
agenda	sakliste, dagsorden; (tids)planleggjar/(tids)planlegger, sjuande sans / sjuende sans
body	trusetrøye, trusebluse, kroppsdrakt
clickbait	klikkagn, klikkfang
bias	slagside
site	vevstad/vevsted, nettstad/nettsted
street credibility	gatetruverd/gatetroverdighet
edutainment	leik-og-lær/lek-og-lær(-program), kunnskapsleik/kunnskapslek
mailing list	e-postliste
preset	førehandssetje/forhåndssette, førehandsinnstille/forhåndsinnstille
jetlag	jet(t)sjuke/jet(t)syke, jet(t)ørske, døgnville/døgnvillhet
webserver	nettenar/nettjener, vevtenar/vevtjener
breaking news	siste nytt, nyhendevarsel/nyhetsvarsel, akkurat no / akkurat nå, no:/nå, siste
co-branded	samprodukt
green	holområde/hullområde (i golf)
leading zero	leiande null / ledende null, førestilt null / foranstilt null
true crime	krim frå røyndomen / krim fra virkeligheten, røyndomskrim/virkelighetskrim, krimdokumentar, dokukrim
chatbot	samtalerobot, praterobot
gründer	grunnleggjar/grunnlegger (nøytralt); jobbar/jobber (negativt); jobbskapar/jobbskaper (positivt)
horrorfilm	grøssar/grøsser, skrekkfilm
disruptive technology	brytningsteknologi
tap screen	trykkskjerm
themes	tema, drakt, ham (IKT), jf. skins
mountain bike	terrengsykkel, jf. offroad-sykkel
namedropping	namnestrøing/navnestrøing, namnedryping/navnedrypping, namneskvetting/navneskvetting
polish	poler(ings)middel, pussemiddel, polisj
balanced scorecard (bsc)	balansert målstyring (BMS)
highlight	høgdepunkt/høydepunkt
interface	grensesnitt
patient pathway	pasientforløp/pasientløype
tablet	nettbrett, tavle-pc
amplifier	forsterkar/forsterker
corner	hjørnespark, hjørnekast (idr.)
dotcom-selskap	nettselskap
webside	nettside
hashtag	emneknagg
heavy rock	tungrock
smoothie	smudi
business-to-government	handel med offentleg sektor / handel med offentlig sektor
instant messaging	direktemeldingst(j)eneste, snøggmeldingsteneste/hurtigmeldingstjeneste
memory stick	minnepinne
disc-at-once	heilbrenning/helbrenning, einøktsbrenning/enøktsbrenning, jf. session-at-once
stand-up-komikar/stand-up-komiker	spontankomikar/spontankomiker, ståoppkomikar/ståoppkomiker
teaser	smakebit
mashup	nettfletting (IKT)
notebook	berbar (datamaskin) / bærbar (datamaskin) (IKT)
pager	personsøkjar/personsøker
storyboard	dreiebok
boom	høgkonjunktur/høykonjunktur (økon.), brå oppgang, brå oppsving (allment); i ordsammensetninger gjerne -bølgje/-bølge, jf. babyboom
cracker	datapirat
frozen shoulder	frosen skulder / frossen skulder (med.)
fighting spirit	kampånd, kampglød, gå-på-humør
hosting (med eng. uttale)	netthotell, utleige/utleie
human resource manager	personalsjef
brain drain	hjerneflukt
coache	trene, rettleie/veilede
data mart	datatorg, datamarknad/datamarked
motion capture	rørsleopptak/bevegelsesopptak
community-ansvarleg	nettvert, redaktør, nettstammeansvarleg/-ansvarlig, nettgruppe-, nettsamfunn- (på Internett)
enter(tast)	linjeskift(tast), retur(tast)
hosted (med eng. uttale)	utleigd/utleid
microchip	(data)brikke, mikrobrikke, integrert krins / integrert krets, jf. chip, integrated circuit
pink	rosa, lyseraud/lyserød
rss feed	nyheitsvarsling/nyhetsvarsling, -mating
backbone	stamnett (IKT)
business-to-government (b2g)	sal til det offentlege / salg til det offentlige (= business-to-administration (B2A))
disclaimer	ansvarsfråskriving, atterhald / ansvarsfraskrivelse, forbehold
implementere	setje i verk/iverksette, setje ut i livet / sette ut i livet, gjennomføre
twitter	se tweet
data warehouse	datavarehus
hanggliding	hengeflyging, hengegliding
bucket list	kisteliste
house	huse (andres operative maskinvare i eigne lokale mot betaling), jf. hoste
public service (broadcasting)	allmennkringkasting
print on demand (pod)	trykk etter behov (TEB), bestillingstrykk, tingingstrykk, jf. publishing on demand
marketing	marknadsføring/markedsføring
retail version	forhandlarversjon/forhandlerversjon, salsversjon/salgsversjon (IKT)
e-commerce	e-handel, netthandel
holding company	eigarselskap/eierselskap, holdingselskap
layout	grafisk utforming, oppsett, bladbunad, jf. design
compliance auditing	etterlevingsrevisjon/etterlevelsesrevisjon, samsvarsrevisjon
food processor	kjøkkenmaskin, matmølle, matprosessor, matkvern
policy	politikk, taktikk, retningslinjer
business case	prosjektgrunngjeving/prosjektbegrunnelse, verksemdsscenario/virksomhetsscenario, forretningsgrunnlag, konseptgrunnlag
carjacking	bilkapring
clutch	koplingspedal, kløtsj
catering	matlevering; selskapsmat
e-mail	jf. mail
franchising	forhandlarrettssamarbeid/forhandlerrettssamarbeid, forhandlaravtale/forhandleravtale
inline skates	(«linjeskøyter», dvs. rulleskøyter med hjulene på rekke:) rulleskøyter
double backslash (\\)	dobbel omvend skråstrek / dobbelt omvendt skråstrek, jf. backslash
printe	skrive ut
bear market	bjørnemarknad/bjørnemarked 
display	skjerm, teiknrute/tegnrute, (tekst)vindauge/(tekst)vindu (t.d. på telefonen)
coach	trenar/trener, rettleiar/veileder, leiar/leder, rådgjevar/rådgiver
sudden death	førstemålsspel/førstemålsspill
backup	reservekopi, tryggingskopi/sikkerhetskopi (IKT); støtte, hjelp, oppfølging (allment); jf. backing
cruise control	fartshaldar/fartsholder
instant coffee	pulverkaffi/pulverkaffe
tweet	(substantiv:) tvitring, tvitt, twittermelding, kvitter, kvitring
booke	bestille, tinge; reservere; skrive seg inn
connector	port, utgang, kontakt, koplingspunkt (maskinvare); portnar/portner, bindeledd (programvare)
heade	nikke, skalle, stange, hedde
phishing	nettfisking
cageball	burball
corporate social responsibility (csr)	samfunnsansvaret til bedrifta / bedriftens samfunnsansvar
headhunting	handplukking/håndplukking, hovudjakt/hodejakt, utveljing/utvelging
human resource management (hrm)	leiing av personalressursar  / ledelse av personalressurser, leiing av menneskelege ressursar (LMR) / Ledelse av menneskelige ressurser (LMR)
news on demand	nyheiter etter (ved) behov, på bestilling / nyheter etter (ved) behov, på bestilling, jf. on demand
pitch	innsal/innsalg
backpacker	ryggsekkturist
base camp	baseleir
fintech	finansteknologi
reality-tv	røyndoms-TV/virkelighets-TV, dokusåpe
babyboom	babybølgje/babybølge, fødselsbølgje/fødselsbølge, jf. boom
economies of agglomeration	samlokaliseringsfordelar/samlokaliseringsfordeler
link	lenkje/lenke, peikar/peker, kopling (IKT)
world wide web	Verdsveven/Verdensveven
browse	bla, bla igjennom, lese
fighter	kjempar/kjemper, faitar/faiter
hangover	fyllesjuke, tømmermenn, bakrus
prime time	beste sendetid
slow motion	sakte film, langsam kino / langsom kino
toastmaster	visevert, kjøkemeister/kjøkemester
audition	prøvespel/prøvespill, rolleprøve, opptaksprøve
matche	passe saman med / passe sammen med, stå til; komme opp mot, måle seg med
overheadprojektor	skriftprosjektør, lysarkvisar/lysarkviser
walkover	autoopprykk; gratissiger/gratisseier
weekend	helg, vekeslutt/ukeslutt
case study	kasusstudie, tilfellestudie, eksempelstudie, dømestudie
chunk	klump, bit
inside trading	innsidehandel
search path	søkjebane/søkebane, søkjeveg/søkevei (i operativsystem), jf. browse path
surround sound	kringlyd
restart	omstart, varmstart, jf. boote (IKT)
accountability	ansvarsutkreving, ansvarleggjering/ansvarliggjøring
chatte	prate på nettet, nettprate, (humor.:) tjatte, tjatre
integrated circuit	integrert krins / integrert krets, (data)brikke, jf. chip
hacker	datasnok
teamwork	lagarbeid, samarbeid
access point	tilgangspunkt
account manager	kundeleiar/kundeleder, kundeansvarleg/kundeansvarlig, kundekontakt, jf. key account manager
actionfilm	spenningsfilm, valdsfilm/voldsfilm
road-movie	landevegsfilm/landeveisfilm
stakeholder	interessent
booking	bestilling, tinging; reservasjon
gate	utgang (på flyplass)
impact	samfunnsbidrag
drawback	ulempe, bakdel, mangel
scanne	skanne, avlese
leisure wear	fritidsklede/fritidsklær
retweet	gjentvitre/oppattvitre, retvitre
screen shot	skjermdump, skjermbiletkopi/skjermbildekopi
governance	styring (og ettersyn); delaktighetsstyring; styresett
newsfeed	nyheitsvarsling/nyhetsvarsling, -mating, -straum/strøm
overhead	skriftprosjektør, lysarkvisar/lysarkviser (tekn.); lysark, transparent (tekn.); administrasjonskostnader, felleskostnader (økon.)
touchpad	styreplate, peikeplate/pekeplate (IKT)
community	lokalsamfunn, nettgruppe, nettsamfunn
corporate governance	eigarstyring og selskapsleiing / eierstyring og selskapsledelse
earcon	lydikon, lydlogo, jf. auditory icon
scanner	skannar/skanner, avlesar/avleser
carport	open garasje / åpen garasje, bilbås
makeup	sminke
option	val/valg, alternativ, moglegheit/mulighet (allment); opsjon (økon./pol.); funksjonsval/funksjonsvalg (IKT)
spin-off	avspinn, sideverknad/sidevirkning, sideeffekt
fanklubb	beundrarklubb/beundrerklubb, venelag
literature review	litteraturgjennomgang
sidebar	sidestolpe, infostolpe (IKT)
business-to-consumer (b2c)	detaljhandel
facility management	næringsforvaltning, eigedomsforvaltning/eiendomsforvaltning, bygningsforvaltning
flow chart	flytskjema, flytdiagram
peer review	fagfellevurdering, kollegavurdering
sample	punktprøve (tekn.); lydsnutt, videosnutt (mus., media); utval/utvalg (samf.vit.)
binge watching	seriemaraton, seriefråtsing, tv-fråtsing
blame game	skuldspel/skyldspill, skuldfordelingsspel/skyldfordelingsspill,  syndebukkspel/syndebukkspill
board	(reklame)tavle, reklame(skilt)
sunk cost	tapt kostnad, irreversibel kostnad
windsurfing	brettsegling/brettseiling
push-up-bh	heve-BH, løfte-BH
release notes	produktmerknader, versjonsmerknader (IKT)
roller blades	(eg. inline skates «linjeskøyter») rulleskøyter
fighte	slåss/slåst, kjempe, konkurrere, faite
header	topptekst, jf. footer (IKT)
proxy server	mellom(ledds)tenar/mellom(ledds)tjener
on demand	etter behov, behovs-, -bestillings-, tingings-, på førespurnad / på forespørsel, jf. news, print, publishing og video on demand
reset	tilbakestille, nullstille
shabby chic	lurvelekkert
webinar	nettseminar
whiteboard-tusj	tavletusj
crew	stab, arbeidslag, gruppe, besetning, mannskap
freelance	frilans (adj.); frilansar/frilanser (subst.)
in-house	intern-, firma- (i samansetjingar), sjølv/selv, på huset
degrowth	nedvekst
flatshare	bufellesskap/bofellesskap, medbuarskap/medboerskap, kollektiv
fuzzy logic	ullen logikk, flytande / flytende logikk, lodden logikk, linn logikk
pulled pork	plukksvin
assist	målgjevande pasning / målgivende pasning (fotball)
backstage	bak scenen, bakscenes
bull market	oksemarknad/oksemarked 
clou (frå fransk)	høgdepunkt/høydepunkt, glansnummer
knowhow	fagkunnskap, faginnsikt, ekspertise
take-away-food	hentemat, ta-med-mat
stashe	stase (seg opp), pynte (seg)
flight recorder	ferd(s)skrivar/ferd(s)skriver
food truck	matvogn, matbil
hat trick	trillingmål
hostmaster	namnemeister/navnemester, namneforvaltar/navneforvalter (for særskilde Internett-tenester)
management consultant	bedriftsrådgjevar/bedriftsrådgiver, strategirådgjevar/strategirådgiver
online	oppkopla/oppkoplet, tilkopla/tilkoplet, på nettet (IKT); tilgjengeleg/tilgjengelig eller «med» (sjargong), jf. offline
benchmark	referansenivå, -norm, -verdi, styringsmål, (allment/nær.liv); fastmerke (landmåling)
e-learning	e-læring
halfpipe	(snø)renne (jf. takrenne), halvpipe («i pipa»), halvrør («i røret»)
e-reader	lesebrett
general data protection regulation (gdpr)	personvernforordningen (PVF)
mnemonic	hugsesymbol/huskesymbol, hugseregel/huskeregel
producer	produsent, produksjonsleiar/produksjonsleder, produksjonsansvarleg/produksjonsansvarlig
auditory icon	lydikon, lydlogo, auditivt ikon, jf. earcon
blackpacker	(humor.:) svartsekk (jf. backpacker)
e-cash	e-pengar/e-penger, digitale pengar / digitale penger
spam	søppelpost
spoiler alert	plottblottar/plottblotter, røpealarm, røpevarsel
trigger	utløysande faktor / utløsende faktor, inspirasjonskjelde/inspirasjonskilde
competitive edge	konkurransefordel, konkurranseforsprang
docu-soap	dokumentarsåpe, dokusåpe
just-in-time-prinsippet	i-rett(e)-tid-prinsippet, der-og-da-prinsippet
footer	botntekst/bunntekst, jf. header (IKT)
hibernation mode	dvalemodus (IKT)
joystick	styrespak, kontrollspak
research	(for)undersøking/(for)undersøkelse, kjeldearbeid/kildearbeid
tutorial	rettleiing/veiledning
call center	kundesenter, kundetelefon, jf. help desk
eyewear	augetøy/øyetøy
feedback	tilbakemelding, respons, reaksjon, tilbakekopling, svar
goodwill	velvilje, godvilje
heading	overskrift, tittel (media); nikking, hedding (idr.)
oppbacking	oppbakking, jf. backing
space manager	vareansvarleg/vareansvarlig
stout	stautøl
applet	miniprogram, javasnutt
crowd funding	kronerulling (på nett), pengeinnsamling, folkefinansiering
doughnut	(amerikansk) smultring
voice mail	talepost
flatmate	bufelle/bofelle, medbuar/medboer
sampling	punktprøving (tekn.); digitalisering (mus., media); direkte utdeling av vareprøver (nær.liv)
timesharing	tidsdeling, deltidsbruk; deltids(l)eige/deltids(l)eie
attach	leggje/legge ved, sende med
beacon	mobilfyr
child grooming	barnelokking
no-platform	scenenekt
space management	varestyring
widescreen	breiskjerm/bredskjerm
comeback	tilbakekomst
downlight	(innfelt) nedlys
human resource (hr)	personalressurs
mountain biking	terrengsykling, jf. offroad-sykkel
weasel	beltebil
cloud computing	nettsky (IKT)
refill	påfyll
promotion	salsframstøyt/salgsframstøt; (fram)hjelp, fremming, promotering
skippe	late vere / la være, hoppe over, sløyfe, kutte ut
supply-båt	forsyningsbåt
voucher	studiebillett, studiesertifikat (utd.); (hotell)kupong
fast food	kjappmat, hurtigmat, snøggmat, gatekjøkkenmat, jf. junk food
flight	(fly)avgang, (fly)rute, flyging/flygning, flytur
moderator	debattleder, ordstyrer